1111111111111111111111
1000000001000000000001
1011111101000000000001
1010000001000011101001
1010000111100000000001
1011110001000000000001
1000000001000000000001
1000000001000000000001
1111111111111111111111
